111111111
1E0CP1111
111101111
111101111
1111C1111
111111111
