1111111111111
1PCE000000C11
1000000000001
1000100C00001
10C0000000001
10000100000C1
1111111111111
