11111111
11E10011
111PC101
11111111