11111111
11000011
110P1011
10011001
100C10E1
11111111