11111111
11E10011
111P1101
11111111