1111111111111
10CE000000C11
1000000000001
1000100C00001
10C0000P00001
10000100000C1
1111111111111
