11111111111
1P0CCCCCCE1
11111111111