11111111
11E11111
111P11C1
11111111