11111111111
10000000001
10C001000E1
10000P10001
10000100001
11111111111