11111111111111111
1E000P000C1111111
11111111111111111
1sssssssssssssss1
11111111111111111
10000000001111111
11111111111111111