11111111111111111111111
100E000000C110000000001
10000000000011111100001
1000100C000000000000001
10C0000P000011111101111
10000100000C10000000001
11111111110010011111111
11111110000010011111111
11110000000110011111111
11000000001110011111111
1111011100C000011111111
11100111110111111111111
11110011100C01111111111
11111011111100111111111
11111001111110011111111
11111100111111001111111
11111110000C00001111111
11111111111111111111111
11111111111111111111111
