11111111
1EC000P1
11101111
11111111