11111111111111111111
10000000000000000001
100000000C0000000001
10000000000000000001
100000000E000C000001
10000000000000000001
100000000C0000000001
10000000000000000001
100000000P0000000001
10000000000000000001
10000000000000000001
11111111111111111111
