1111111
1000E01
1000C11
1P00001
1111111