1111111111111111111
1E000000P00000000C1
1000000000000000001
1111110111111111111
10000000000000C0001
100000000000C000001
1111111111111111111